####C########C########C####
#...D...#....D....#...D...#
#..T.T..#...T.T...#..T.T..#
#.......#.........#.......#
##..#####....#....#####..##
#.........................#
#.........................#
#..RRRR.........RRRR......#
#..RRRR.........RRRR......#
#..RRRR.........RRRR......#
#..RRRR.........RRRR......#
#.........................#
#.........................#
#..SS.....................#
#..SS.....................#
#.........................#
#.........................#
###########################
